type octile
height 31
width 28
map
TTTTTTTTTTTTTTTTTTTTTTTTTTTT
T............TT............T
T.TTTT.TTTTT.TT.TTTTT.TTTT.T
T.TTTT.TTTTT.TT.TTTTT.TTTT.T
T.TTTT.TTTTT.TT.TTTTT.TTTT.T
T..........................T
T.TTTT.TT.TTTTTTTT.TT.TTTT.T
T.TTTT.TT.TTTTTTTT.TT.TTTT.T
T......TT....TT....TT......T
TTTTTT.TTTTT.TT.TTTTT.TTTTTT
@@@@@T.TTTTT.TT.TTTTT.T@@@@@
@@@@@T.TT..........TT.T@@@@@
@@@@@T.TT.TTT..TTT.TT.T@@@@@
TTTTTT.TT.T......T.TT.TTTTTT
..........T......T..........
TTTTTT.TT.T......T.TT.TTTTTT
@@@@@T.TT.TTTTTTTT.TT.T@@@@@
@@@@@T.TT..........TT.T@@@@@
@@@@@T.TT.TTTTTTTT.TT.T@@@@@
TTTTTT.TT.TTTTTTTT.TT.TTTTTT
T............TT............T
T.TTTT.TTTTT.TT.TTTTT.TTTT.T
T.TTTT.TTTTT.TT.TTTTT.TTTT.T
T...TT................TT...T
TTT.TT.TT.TTTTTTTT.TT.TT.TTT
TTT.TT.TT.TTTTTTTT.TT.TT.TTT
T......TT....TT....TT......T
T.TTTTTTTTTT.TT.TTTTTTTTTT.T
T.TTTTTTTTTT.TT.TTTTTTTTTT.T
T..........................T
TTTTTTTTTTTTTTTTTTTTTTTTTTTT